R 1024 768
NO ./textures/bluestone.xpm
SO ./textures/eagle.xpm
WE ./textures/purplestone.xpm
EA ./textures/wood.xpm
S ./textures/pistol.xpm
C 225,30,35
F 200,	135,  30


1111111111111111111111111
1000000000110000000000001
1011000001110000002000001
1001000000000000000000001
111111111011000001110000111111111
100000000011000001110111111111111
11110111111111011100000010001
11110111111111011101010010001
11000000110101011100000010001
1000200000000000110N000000001
10000000000000001101010000001
1100000111010101111101110000111
11110111 1110101 101111000001
11111111 1111111 111111111111
